个性	个性
中央	中央
主机	主机
亮度	亮度
亮点	亮点
价格	价格 价钱 标价 价位
优点	优点 优势 好处
传统	传统
位置	位置
低扭	低扭
低调	低调
低速	低速
体积	体积
作用	作用
侧倾	侧倾
保有量	保有量
信号	信号
信息	信息
倾斜度	倾斜度 倾角
做工	做工
储物	储物
全景	全景
典范	典范
内容	内容
内衬	内衬
内饰板	内饰板
冷车	冷车
净重	净重
刚性	刚性
初段	初段
前台	前台
力度	力度 力道 力量
功劳	功劳
功率	功率
动作	动作
动力	动力
动力性	动力性
动态	动态
动感	动感
动静	动静
包裹	包裹 包皮
包裹性	包裹性
升降键	升降键
卡扣	卡扣
卤素	卤素
厂家	厂家
厚度	厚度
厚重感	厚重感
参数	参数
反光	反光
反应	反应
口碑	口碑
可靠性	可靠性
后劲	后劲
后排	后排
后背	后背
味道	味道
品牌	品牌 牌子
品质	品质
响声	响声
噪音	噪音 噪声
四驱	四驱
回头率	回头率
图片	图片
坐姿	坐姿
坡度	坡度
垃圾	垃圾
型号	型号
基因	基因
基础	基础
塑料	塑料
塑料感	塑料感
声浪	声浪
声音	声音
外壳	外壳
外观	外观 外表 外形 外型
多媒体	多媒体
大小	大小
头部	头部
头顶	头顶
好坏	好坏
姿态	姿态
安全性	安全性
实用性	实用性
容量	容量
宽度	宽度
密封性	密封性
导航	导航
寿命	寿命
封闭性	封闭性
尺寸	尺寸
尾部	尾部
尾门	尾门
层次	层次
层次感	层次感
工作台	工作台
工艺	工艺
差距	差距
布局	布局
平台	平台
平顺性	平顺性
开关	开关
异味	异味
异响	异响
弧度	弧度
弧线	弧线
弹簧	弹簧
强度	强度
形状	形状
影像	影像
怠速	怠速
性价比	性价比
性感	性感
性能	性能
总成	总成
情况	情况
感应	感应
感觉	感觉
成本	成本
手感	手感
扭力	扭力
扭矩	扭矩
技术	技术
护板	护板 护甲
拉杆	拉杆
拉线	拉线
指向性	指向性
按钮	按钮 按键
挡板	挡板
排量	排量
接口	接口
接缝	接缝 接缝处
控制区	控制区
控制器	控制器
控制键	控制键
推背感	推背感
插口	插口
操控	操控
操控性	操控性 操控感
支撑性	支撑性 支撑力
支架	支架
故障	故障
故障率	故障率
效果	效果
效率	效率
数据	数据
数量	数量
整体	整体 总体 一体 整车
整体性	整体性 整体感
方向	方向
方向感	方向感
方式	方式
旋钮	旋钮
时尚	时尚
时速	时速
时间	时间
智能	智能
暖风	暖风
曲线	曲线
机械	机械
机油	机油
机舱	机舱
杂音	杂音
材料	材料 材质 用料 用材
杯架	杯架
板金	板金
极限	极限
构造	构造
柔软度	柔软度
标准	标准
标志	标志
样式	样式 样子
格调	格调
桃木	桃木
框架	框架
档位	档位
档次	档次
档次感	档次感
模式	模式
横向	横向
款式	款式
比例	比例
气味	气味
氛围	氛围
水平	水平 水准
水温	水温
油漆	油漆
油耗	油耗
流线	流线
流线型	流线型
浅色	浅色
海绵	海绵
涡轮	涡轮
液压	液压
深度	深度 深浅
清晰度	清晰度
渗油	渗油
温度	温度
漆面	漆面
潜力	潜力
潮流	潮流
激光	激光
灯光	灯光
灵敏度	灵敏度
灵活性	灵活性
照明	照明
照片	照片
燃油	燃油
爆发力	爆发力
版本	版本
特点	特点 特性
状态	状态 状况
电子	电子
电机	电机
电源	电源
电调	电调
皮套	皮套
皮带	皮带
皮革	皮革
盖板	盖板
盲区	盲区
直径	直径
省油	省油
硬度	硬度 硬质
磨合期	磨合期
科技	科技
科技感	科技感
积碳	积碳
称号	称号
程序	程序
稳定性	稳定性
空间	空间
系统	系统
级别	级别
纵向	纵向
线性	线性
线束	线束
线条	线条
线路	线路
组件	组件
组合	组合
细节	细节
织物	织物
经济	经济
经济性	经济性
绒布	绒布
结合处	结合处 结合点
结构	结构
缝线	缝线
缝隙	缝隙
缺点	缺点 缺陷
耐用性	耐用性
肌肉感	肌肉感
胎压	胎压
胎噪	胎噪
能力	能力
脚感	脚感
脾气	脾气
腰线	腰线
腿部	腿部
自重	自重
舒适性	舒适性 舒适型 舒适度 舒适感
节奏	节奏
花纹	花纹
范围	范围
虚位	虚位
螺丝	螺丝
行程	行程
表面	表面
装备	装备
装潢	装潢
要求	要求
规格	规格
视线	视线
视觉	视觉
视野	视野
视频	视频
角度	角度
触感	触感
记忆	记忆
设计感	设计感
调校	调校 调教
豪华感	豪华感
质地	质地 质感
质量	质量
贴膜	贴膜
费油	费油
距离	距离
路感	路感
车型	车型
车速	车速
轨道	轨道
转速	转速 转数
轮廓	轮廓
软包	软包
软质	软质 软性
轴承	轴承
轴距	轴距
辨识度	辨识度
边缘	边缘
运动感	运动感
近光灯	近光灯
远光	远光
透镜	透镜
通病	通病
通过性	通过性
速度	速度
造型	造型 功能
配件	配件 部件
配色	配色
重心	重心
重量	重量 轻重
金属	金属
钢板	钢板
钣金	钣金
铁皮	铁皮
长度	长度
门槛	门槛
门缝	门缝
问题	问题
间距	间距 间隙
隐私	隐私
隔板	隔板
隔音	隔音
隔音棉	隔音棉
静音	静音
面料	面料
面板	面板
面积	面积
韧性	韧性
音效	音效 音响效果
音质	音质
音量	音量
顶灯	顶灯
顿挫感	顿挫感
颜值	颜值
颜色	颜色
颠簸感	颠簸感
风格	风格
马力	马力
骨架	骨架
高度	高度 高低
鼓包	鼓包
