汽车	汽车 车 车辆 车子 轿车
发动机	发动机 引擎
机体组	机体组
气缸盖罩	气缸盖罩
气缸盖	气缸盖
气缸体	气缸体
油底壳	油底壳
曲柄连杆机构	曲柄连杆机构
曲轴	曲轴
飞轮	飞轮
活塞	活塞
连杆	连杆
配气机构	配气机构
凸轮轴	凸轮轴
进气凸轮轴	进气凸轮轴
排气凸轮轴	排气凸轮轴
凸轮	凸轮
气门	气门
进气门	进气门
排气门	排气门
气门弹簧	气门弹簧
气门挺柱	气门挺柱
顶杆	顶杆
摇臂	摇臂
进气系统	进气系统
进气歧管	进气歧管
进气管	进气管
节气门	节气门
油门	油门 加速器
踏板	踏板
空气滤清器	空气滤清器
涡轮增压器	涡轮增压器
排气系统	排气系统
排气歧管	排气歧管
排气管	排气管
三元催化转化器	三元催化转化器
消声器	消声器
燃料供给系统	燃料供给系统
燃油箱	燃油箱
燃油泵	燃油泵
燃油滤清器	燃油滤清器
燃油调压器	燃油调压器
喷油器	喷油器
冷却系统	冷却系统
水箱	水箱
水泵	水泵
水管	水管
水套	水套
冷却液	冷却液
散热器	散热器
润滑系统	润滑系统
机油滤网	机油滤网
机油泵	机油泵
机油滤清器	机油滤清器
点火系统	点火系统
高压点火线	高压点火线
火花塞	火花塞
起动系统	起动系统
蓄电池	蓄电池 蓄电池组 电池 电池组
起动电机	起动电机
底盘	底盘 地盘 底板
传动系统	传动系统
离合器	离合器
膜片弹簧	膜片弹簧
摩擦片	摩擦片
变速器	变速器 变速箱
变速杆	变速杆
换挡拉杆	换挡拉杆
换挡拨叉	换挡拨叉
同步器	同步器
齿轮	齿轮
传动轴	传动轴
差速器	差速器
驱动桥	驱动桥
行驶系统	行驶系统
车架	车架
悬架	悬架
控制臂	控制臂
稳定杆	稳定杆
减振器	减振器 减震器
螺旋弹簧	螺旋弹簧
车轮	车轮 轮子
前轮	前轮
后轮	后轮
轮毂	轮毂 轮圈
轮辋	轮辋
轮辐	轮辐
轮胎	轮胎
备胎	备胎
转向系统	转向系统
方向盘	方向盘
转向轴	转向轴
转向器	转向器
转向拉杆	转向拉杆
制动系统	制动系统
行车制动系统	行车制动系统
刹车	刹车 制动器
制动盘	制动盘 刹车盘
制动钳	制动钳
刹车片	刹车片
制动助力器	制动助力器
制动油管	制动油管
驻车制动系统	驻车制动系统
手刹	手刹
驻车制动拉索	驻车制动拉索
驻车制动蹄片	驻车制动蹄片
紧急制动辅助系统	紧急制动辅助系统
防抱死制动系统	防抱死制动系统
车身	车身 车体
车头	车头 前脸
保险杠	保险杠
进气格栅	进气格栅 格栅
发动机盖	发动机盖 引擎盖
翼子板	翼子板
车标	车标
车顶	车顶
顶盖	顶盖
行李架	行李架
车尾	车尾 屁股
尾翼	尾翼 扰流板
后备厢	后备厢 后备箱 行李箱
后备厢盖	后备厢盖 后备箱盖
车门	车门
门板	门板
后视镜	后视镜
铰链	铰链
门锁	门锁
扶手	扶手
拉手	拉手 把手
胶条	胶条 密封条
车窗	车窗 窗户
风窗	风窗
雨刮器	雨刮器
洗涤器	洗涤器
侧窗	侧窗
后窗	后窗
天窗	天窗
玻璃	玻璃
升降机	升降机 升降器
车厢	车厢
座椅	座椅 座位
座垫	座垫 坐垫 垫子
靠背	靠背 椅背
头枕	头枕
座套	座套
填充物	填充物
安全带	安全带
调节机构	调节机构
中控台	中控台
内饰	内饰 装饰
塑料件	塑料件
脚垫	脚垫
遮阳板	遮阳板 遮阳帘
安全气囊	安全气囊 气囊
储物格	储物格 储物槽 储物盒 储物箱
地板	地板
电气设备	电气设备
车灯	车灯 灯 车灯组
前灯	前灯 前灯组
前照灯	前照灯 行车灯 照明灯 前大灯 大灯
灯泡	灯泡
转向灯	转向灯
雾灯	雾灯
尾灯	尾灯 尾灯组
制动灯	制动灯 刹车灯
倒车灯	倒车灯
发电机	发电机
电脑	电脑
仪表盘	仪表盘 仪表 仪表台
车速表	车速表
指针	指针
里程表	里程表
转速表	转速表
压力表	压力表
水温表	水温表
燃油表	燃油表
空调	空调 空调设备
压缩机	压缩机
风扇	风扇
喇叭	喇叭
音响	音响 音箱
雷达	雷达
显示屏	显示屏 屏幕 液晶屏
摄像头	摄像头
传感器	传感器
天线	天线
收音机	收音机
