汽车	汽车 车 车子 车辆
车头	车头 头部
车身	车身 车体
车尾	车尾 屁股 尾部
车门	车门
车窗	车窗 窗户
车轮	车轮 轮子
车灯	车灯
底盘	底盘 底架
发动机	发动机 引擎
变速箱	变速箱 变速器	
油门	油门 加速器
刹车	刹车 制动器
离合器	离合器
方向盘	方向盘
仪表盘	仪表盘
座椅	座椅 座位
空调	空调
雷达	雷达
音响	音响
内饰	内饰
导航	导航
喇叭	喇叭
后备箱	后备箱 行李箱
气囊	气囊
天窗	天窗
引擎盖	引擎盖
铰链	铰链
储物格	储物格 储物盒
车门开关	车门开关
玻璃	玻璃
车窗开关	车窗开关
车窗按钮	车窗按钮
升降机	升降机
轮胎	轮胎
轮毂	轮毂
大灯	大灯 前灯 照明灯
尾灯	尾灯 后灯
雾灯	雾灯
刹车灯	刹车灯
皮带	皮带
隔音板	隔音板
齿轮	齿轮
油门踏板	油门踏板
刹车踏板	刹车踏板
离合器踏板	离合器踏板
椅面	椅面
椅背	椅背 靠背
座垫	座垫 坐垫
安全带	安全带
皮套	皮套
滤芯	滤芯
压缩机	压缩机
空调旋钮	空调旋钮
空调按钮	空调按钮
空调开关	空调开关
排水孔	排水孔
遮阳帘	遮阳帘
